                   |                  |         |
Altair8800:         Altair 8800
Amstrad:            Amstrad CPC
ao486:              IBM 386-Compatible
Apogee:             Apogee BK-01
Apple-I:            Apple I
Apple-II:           Apple IIe
Aquarius:           Mattel Aquarius
Archie:             Acorn Archimedes
Atari800:           Atari 800XL/...
AtariST:            Atari ST/STE
                   |                  |         |
Atom:               Acorn Atom				
BBCMicro:           BBC Micro / Master
BK0011M:            BK0011M
C16:                Commodore 16
C64:                Commodore 64
CoCo3:              TRS-80 CoCo 3					   
EDSAC:              EDSAC
Electron:           Acorn Electron
F68kMiSTer:         X68000
Galaksija:          Galaksija
                   |                  |         |
Jupiter:            Jupiter Ace
MacPlus:            Macintosh Plus
Minimig:            Amiga
mister_coco:        TRS-80 CoCo 3
MSX:                MSX
MultiComp:          MultiComp
ORAO:               Orao
Oric:               Oric
PDP1:               PDP-1
PET2001:            Commodore PET 2001
                   |                  |         |
QL:                 Sinclair QL
release-MiSTerDemu: PC-8801
SAMCoupe:           SAM Coupe
SharpMZ:            Sharp MZ
Specialist:         Specialist/MX
SS:                 SPARCstation
Ti994a:             TI-99/4A
TRS-80:             TRS-80
TSConf:             TS-Config
Vector-06C:         Vector-06C
                   |                  |         |
VIC20:              Commodore VIC-20
X68000:             X68000
ZX-Spectrum:        ZX Spectrum
ZX81:               ZX81


                   |                  |         |
Astrocade:          Bally Astrocade
Atari2600:          Atari 2600
Atari5200:          Atari 5200
Atari7800:          Atari 7800					 
AY-3-8500:          AY-3-8500
C2650:              Arcadia 2001
ColecoVision:       ColecoVision
Gameboy:            Game Boy/Color
GBA:                Game Boy Advance
Genesis:            Mega Drive
                   |                  |         |
Intv:               Intellivision
Jaguar:             Atari Jaguar
MegaCD:             Mega-CD
NeoGeo:             Neo Geo MVS/AES
NES:                Famicom
Odyssey2:           Magnavox Odyssey2
SMS:                Master System & GG
SNES:               Super Famicom
TurboGrafx16:       PC Engine/CD
Vectrex:            Vectrex

                   |                  |         |
Chip8:              CHIP-8
Arduboy:            Arduboy
FlappyBird:         Flappy Bird
GameOfLife:         Game of Life
Hack:               Nand2Tetris Hack

memtest:            SDRAM Test

                   |                  |         |
Gameboy_LLAPI:      GB/GBC #LLAPI
GBA_LLAPI:          GBA #LLAPI
Genesis_LLAPI:      Mega Drive #LLAPI
MegaCD_LLAPI:       Mega-CD #LLAPI
NeoGeo_LLAPI:       Neo Geo #LLAPI
NES_LLAPI:          Famicom #LLAPI
Pacman_LLAPI:       Pac-Man #LLAPI
SMS_LLAPI:          MS & GG #LLAPI
SNES_LLAPI:         SFC #LLAPI
TurboGrafx16_LLAPI: PC Engine #LLAPI





Arkanoid:           Arkanoid      
Asteroids:          Asteroids      
AsteroidsDeluxe:    Asteroids Deluxe              
AtariTetris:        Atari Tetris          
Bagman:             Bagman  
Berzerk:            Berzerk      
BlackWidow:         Black Widow      
BombJack:           Bomb Jack      
BurgerTime:         Burger Time      
                   |                  |         |
BurningRubber:      Burning Rubber          
CanyonBomber:       Canyon Bomber          
Centipede:          Centipede      
ComputerSpace:      Computer Space          
CosmicAvenger:      Cosmic Avenger          
CrazyBalloon:       Crazy Balloon          
CrazyClimber:       Crazy Climber          
CrazyKong:          Crazy Kong      
Defender:           Defender      
DigDug:             Dig Dug  
                   |                  |         |
Dominos:            Dominos      
DonkeyKong:         Donkey Kong      
DonkeyKongJunior:   Donkey Kong Jr.
Dorodon:            Dorodon      
Druaga:             Druaga  
FoodFight:          Food Fight      
Frenzy:             Frenzy  
Galaga:             Galaga  
Galaxian:           Galaxian      
Gaplus:             Gaplus  
                   |                  |         |
GnG:                GnG (old)  
Gyruss:             Gyruss  
IremM62:            Irem M62      
jt1942:             1942  
jt1943:             1943  
jtbiocom:           Bionic Commando      
jtbtiger:           Black Tiger      
jtcommando:         Commando      
jtcps1:             CPS-1  
jtdd:               Double Dragon  
                   |                  |         |
jtdd2:              Double Dragon 2  
jtf1dream:          F-1 Dream      
jtgng:              Ghosts 'n Goblins
jtgunsmoke:         Gun.Smoke      
jtpopeye:           Popeye (JT)
jtsectionz:         Section Z      
jttora:             Tiger Road  
jtvulgus:           Vulgus      
LadyBug:            Lady Bug      
LunarLander:        Lunar Lander   
                   |                  |         |
MarioBros:          Mario Bros      
MCR1:               MCR-1  
MCR2:               MCR-2  
MCR3:               MCR-3  
MCR3Mono:           MCR-3 Monoboard
MCR3Scroll:         MCR-3 Scroll      
MoonPatrol:         Moon Patrol      
NinjaKun:           Ninja Kun      
Pacman:             Pac-Man  
Pengo:              Pengo  
                   |                  |         |
PenguinKunWars:     Penguin-Kun Wars          
Phoenix:            Phoenix      
Pleiads:            Pleiades      
Pong:               Pong  
Pooyan:             Pooyan  
Popeye:             Popeye  
RallyX:             Rally-X  
RiverPatrol:        River Patrol          
Robotron:           Robotron      
RshnAtk:            Green Beret      
                   |                  |         |
Scramble:           Scramble      
SEGASYS1:           SEGA System 1       
SilverLand:         Silver Land      
SnapJack:           Snap Jack      
SolomonsKey:        Solomon's Key          
Sprint1:            Sprint 1      
Sprint2:            Sprint 2      
SuperBreakout:      Super Breakout          
Tecmo:              Tecmo  
TimePilot:          Time Pilot      
                   |                  |         |
TraverseUSA:        Zippy Race          
Ultratank:          Ultra Tank      
Xevious:            Xevious      
Zaxxon:             Zaxxon  
ZigZag:             Zig Zag  
